ae -> UNITED-ARAB-EMIRATES
ar -> ARGENTINA
at -> AUSTRIA
au -> AUSTRALIA
be -> BELGIUM
bg -> BULGARIA
br -> FRANCE
ca -> CANADA
ch -> SWITZERLAND
cn -> CHINA
co -> COLOMBIA
cu -> CUBA
cz -> CZECH-REPUBLIC
de -> GERMANY
eg -> EGYPT
fr -> FRANCE
gb -> UNITED-KINGDOM
gr -> GREECE
hk -> HONG_KONG
hu -> HUNGARY
id -> IDONESIA
ie -> IRELAND
il -> ISRAEL
in -> INDIA
it -> ITALY
jp -> JAPAN
kr -> KOREA
lt -> LITHUANIA
lv -> LATVIA
ma -> MOROCCO
mx -> MEXICO
my -> MALASIA
ng -> NIGERIA
nl -> NETHERLANDS
no -> NORWAY
nz -> NEW_ZEALAND
ph -> PHILIPINES
pl -> POLAND
pt -> PORTUGAL
ro -> ROMANIA
rs -> FRANCE
ru -> RUSSIAN-FEDERATION
sa -> SAUDI-ARABIA
se -> SWEDEN
sg -> SINGAPORE
si -> SLOVENIA
sk -> SLOVAKIA
th -> THAILAND
tr -> TURKEY
tw -> TAIWAN
ua -> UKRAINE
us -> UNITED-STATES
ve -> VENEZUELA
za -> SOUTH-AFRICA